50
50
3
2
11111111111111111111111101111111111111111111111111
10000000000000000000000000000000000000000000000001
10001111111000000111111000000000111111100000000001
10000000000000000000000000000000000000000000000001
10000000000000000000000000000000000000000000000001
11111111100000000000000000000011111000000001111111
10000000000000000000000000000000000000000000000001
10000000000000000000000000000000000000000000000001
10000000000000000000000000000000000000000000000001
10000000000000000000000000000000000000000000000001
10011111111111111111111000000000000000000011111111
10010000000000000000000000000000000000000000000001
10010000000000000011111000000000000000000000000001
10011111100000000000001110111100000000000000000001
10010001000000011111001110111111111111111100000111
10010001000110111111111000000000000000001111001111
10010001001111100000011110111111111100000000000001
10011011011111000000011000000000000000111111111111
10000000000001111011111110111111111100011111000111
10000000000000000000000000000000000000000000000001
00000000000000000000000000000000000000000000000000
10000000000000000000000000000000000000000000000001
10000000000000000000000000000000000000000000000001
10000000000000000000000000000000000000000000000001
10000000000000000000000000000000000000000000000001
10000000000000000000000000000000000000000000000001
10010101010101010101010101010101010101010101010001
10001010101000101010101000101000101010100010101001
10001000000000100000000000100000000000100000001001
10001000000000100000000000100000000000100000001001
10001000000000100000000000100000000000100000001001
10001000000000100000000000100000000000100000001001
10001000000000100000000000100000000000100000001001
10001000000000100000000000100000000000100000001001
10001000000000100000000000100000000000100000001001
10001000000000100000000000100000000000100000001001
10001000000000100000000000100000000000100000001001
10001000000000100000000000100000000000100000001001
10001000000000100000000000100000000000100000001001
10001000000000100000000000100000000000100000001001
10001000000000100000000000100000000000100000001001
10001000000000100000000000100000000000100000001001
10001000000000100000000000100000000000100000001001
10001000000000100000000000100000000000100000001001
10001000000000100000000000100000000000100000001001
10001000000000100000000000100000000000100000001001
10001000000000100000000000100000000000100000001001
10001000000000100000000000100000000000100000001001
10000000000000000000000000000000000000000000000001
11111111111111111111111011111111111111111111111111
